 0, 0, 0, 0, 0, 0, 0, 0, 0, 0, 0, 0, 0, 0, 0, 0, 0, 0, 0,	0, 0 
					 0, 0, 0, 0, 0, 0, 0, 0, 0, 0, 0, 0, 0, 0, 0, 0, 0, 1, 1,	1, 0 
					 0, 0, 0, 0, 0, 0, 0, 0, 0, 0, 0, 0, 0, 0, 0, 0, 0, 51, 4,	1, 0 
					 0, 0, 0, 0, 0, 0, 0, 0, 0, 0, 0, 0, 0, 0, 0, 0, 0, 1, 1,	1, 0 
					 0, 0, 0, 0, 1, 1, 1, 1, 0, 2, 1, 0, 0, 0, 0, 0, 0, 0, 0,	0, 0 
					 0, 0, 0, 0, 1, 0, 0, 0, 3, 2, 1, 1, 1, 1, 0, 0, 0, 0, 0,	0, 0 
					 0, 0, 0, 0, 1, 1, 1, 1, 0, 2, 0, 61, 62, 1, 0, 0, 0, 0, 0, 0, 0 
					 0, 0, 0, 0, 0, 0, 0, 1, 0, 2, 1, 1, 1, 1, 0, 0, 0, 0, 0,	0, 0 
					 0, 0, 48, 100, 100, 0, 0, 1, 0, 2, 1, 0, 0, 0, 0, 0, 0,0, 0, 0, 0 
					 0, 0, 0, 0, 0, 0, 0, 0, 0, 0, 0, 0, 0, 0, 0, 0, 0, 1, 1,	1, 1 
					 0, 0, 0, 0, 0, 0, 0, 0, 0, 0, 0, 0, 0, 0, 0, 0, 0, 52, 4,	1, 0 
					 0, 0, 0, 0, 0, 0, 0, 0, 0, 0, 0, 0, 0, 0, 0, 0, 0, 1, 1,	1, 0 
					 0, 0, 0, 0, 0, 0, 0, 0, 0, 0, 0, 0, 0, 0, 0, 0, 0, 0, 0,	0, 0 