 1, 1, 1, 1, 1, 1, 1, 1, 1, 1, 1, 1, 1, 1, 1, 1, 1, 1, 1,1, 1 
 0, 0, 0, 0, 0, 1, 0, 0, 0, 0, 0, 1, 0, 0, 0, 0, 0, 1, 0,0, 0 
 0, 0, 0, 1, 0, 1, 0, 0, 0, 1, 0, 1, 0, 0, 0, 1, 0, 1, 0,	0, 0 
 0, 61, 0, 1, 0, 1, 0, 0, 0, 1, 2, 1, 0, 0, 0, 1, 0, 1, 0,	0, 0 
 0, 0, 0, 1, 0, 1, 0, 0, 0, 1, 0, 1, 0, 0, 0, 1, 0, 1, 0,	0, 0 
 0, 71, 0, 1, 0, 1, 0, 0, 0, 1, 3, 1, 0, 0, 0, 1, 0, 1, 0,	0, 0 
 0, 0, 0, 1, 2, 1, 0, 0, 0, 1, 0, 1, 0, 0, 0, 1, 2, 1, 0,	0, 0 
 0, 0, 1, 51, 0, 0, 0, 0, 0, 1, 0, 0, 0, 0, 0, 1, 0, 0, 0,	4, 0 
 0, 0, 0, 1, 3, 1, 0, 0, 0, 1, 0, 1, 0, 0, 0, 1, 3, 1, 0,	0, 0 
 0, 81, 0, 1, 0, 1, 0, 0, 0, 1, 2, 1, 0, 0, 0, 1, 0, 1, 0,	0, 0 
 0, 0, 0, 1, 0, 1, 0, 0, 0, 1, 0, 1, 0, 0, 0, 1, 0, 1, 0,	0, 0 
 0, 0, 0, 1, 0, 1, 0, 0, 0, 1, 2, 1, 0, 0, 0, 1, 0, 1, 0,	0, 0 
 0, 0, 0, 1, 0, 1, 0, 0, 0, 1, 0, 1, 0, 0, 0, 1, 0, 1, 0,0, 0 
 0, 48, 110, 0, 0, 1, 0, 0, 0, 0, 0, 1, 0, 0, 0, 1, 0, 1,0, 0, 0 