                 1, 1, 1, 1, 1, 1, 1, 1, 1, 1, 1, 1, 1, 1, 1,1,1, 1 
				 1, 0, 0, 0, 0, 0, 30, 0, 0, 0, 0, 0, 0, 0, 0,0,0, 1 
				 1, 0, 0, 0, 0, 30, 30, 0, 0, 0, 0, 0, 0, 0, 0,0,0, 1  
		     	  1, 0, 0, 0, 30, 0, 0, 0, 0, 0, 0, 0, 0, 0, 0,0,0, 1 
					 1, 0, 0, 30, 30, 0, 0, 0, 0, 0, 0, 0, 0, 31, 0,0,0, 1 
				 1, 0, 0, 31, 0, 0, 30, 30, 0, 0, 0, 0, 0, 0, 0,0,48, 1 
					  1, 0, 0, 0, 30, 0, 0, 0, 0, 0, 0, 0, 0, 0, 0,0,0, 1 
					1, 0, 0, 0, 0, 30, 0, 0, 0, 0, 0, 0, 0, 0, 31,0,0, 1  
					  1, 0, 0, 0, 30, 0, 0, 0, 0, 0, 0, 0, 0, 0, 0,0,0, 1 
					 1, 0, 0, 0, 0, 30, 0, 0, 0, 0, 0, 0, 0, 0, 0,0,0, 1 
					  1, 0, 0, 0, 0, 30, 0, 0, 0, 0, 0, 0, 0, 0, 0,0,0, 1 
					  1, 1, 1, 1, 1, 1, 1, 1, 1, 1, 1, 1, 1, 1, 1,1,1, 1 