0  , 0 , 0 , 0 , 0 , 1 , 0 , 0 , 0 , 0 , 0 , 1 , 0 , 0 , 0 , 0 , 0 , 1 , 0 , 0 , 0
0  , 0 , 0 , 1 , 0 , 1 , 0 , 0 , 0 , 1 , 0 , 1 , 0 , 0 , 0 , 1 , 0 , 1 , 0 , 0 , 0
0  , 0 , 0 , 1 , 0 , 1 , 0 , 0 , 0 , 1 , 2 , 1 , 0 , 0 , 0 , 1 , 0 , 1 , 0 , 0 , 0
48 , 0 , 0 , 1 , 0 , 1 , 0 , 0 , 0 , 1 , 0 , 1 , 0 , 0 , 0 , 1 , 0 , 1 , 0 , 0 , 0
0  , 0 , 0 , 1 , 0 , 1 , 0 , 0 , 0 , 1 , 3 , 1 , 0 , 0 , 0 , 1 , 0 , 1 , 0 , 0 , 0
0  , 0 , 0 , 1 , 2 , 1 , 0 , 0 , 0 , 1 , 0 , 1 , 0 , 0 , 0 , 1 , 2 , 1 , 0 , 0 , 0
0  , 0 , 0 , 1 , 0 , 0 , 0 , 0 , 0 , 1 , 0 , 0 , 0 , 0 , 0 , 1 , 0 , 0 , 0 , 4 , 0
0  , 0 , 0 , 1 , 3 , 1 , 0 , 0 , 0 , 1 , 0 , 1 , 0 , 0 , 0 , 1 , 3 , 1 , 0 , 0 , 0
0  , 0 , 0 , 1 , 0 , 1 , 0 , 0 , 0 , 1 , 2 , 1 , 0 , 0 , 0 , 1 , 0 , 1 , 0 , 0 , 0
0  , 0 , 0 , 1 , 0 , 1 , 0 , 0 , 0 , 1 , 0 , 1 , 0 , 0 , 0 , 1 , 0 , 1 , 0 , 0 , 0
0  , 0 , 0 , 1 , 0 , 1 , 0 , 0 , 0 , 1 , 2 , 1 , 0 , 0 , 0 , 1 , 0 , 1 , 0 , 0 , 0
0  , 0 , 0 , 1 , 0 , 1 , 0 , 0 , 0 , 1 , 0 , 1 , 0 , 0 , 0 , 1 , 0 , 1 , 0 , 0 , 0
0  , 0 , 0 , 0 , 0 , 1 , 0 , 0 , 0 , 0 , 0 , 1 , 0 , 0 , 0 , 0 , 0 , 1 , 0 , 0 , 0