0,0,0,0,0,1,0,1,0,0,0,0,0,0,1,1,1,1,1,1
0,0,0,0,0,1,61,1,0,0,0,0,0,0,1,0,0,0,0,1
0,0,0,0,1,1,0,1,1,0,0,0,0,0,1,0,0,0,0,1
0,0,0,0,1,0,0,0,1,0,0,0,0,0,1,0,1,0,0,1
0,0,0,0,1,0,0,0,1,0,0,0,0,0,1,0,1,0,0,1
0,0,0,0,1,0,1,0,1,0,0,0,0,0,1,0,1,0,0,1
0,0,0,0,1,0,1,0,1,1,1,1,1,1,1,0,1,0,4,1
0,0,0,0,1,0,1,0,0,51,0,0,0,0,0,110,1,1,1,1
0,0,0,0,1,0,1,0,1,1,1,1,1,1,1,1,1,0,0,0
0,0,0,0,1,0,1,0,1,0,0,0,0,0,0,0,0,0,0,0
0,0,0,0,1,0,0,0,1,0,0,0,0,0,0,0,0,0,0,0
0,0,0,0,1,1,0,1,1,0,0,0,0,0,0,0,0,0,0,0
0,0,0,0,0,1,0,1,0,0,0,0,0,0,0,0,0,0,0,0
0,0,0,0,0,1,48,1,0,0,0,0,0,0,0,0,0,0,0,0
