1,1,1,1,1,1,1,1,1,1,1,1,1,1,1,1
1,100,100,100,100,100,100,100,100,1,100,100,100,100,100,1
1,100,100,100,1,100,100,100,100,100,100,100,100,100,100,1
1,100,100,100,100,100,100,100,100,100,100,1,100,100,100,1
1,100,1,100,100,100,100,100,100,100,100,100,100,100,100,1
1,1,100,100,100,100,100,100,100,1,100,100,100,100,100,1
1,100,100,100,100,100,100,100,100,100,100,100,100,100,1,1
1,100,100,100,100,100,100,1,100,100,100,100,100,100,100,0
1,100,100,1,100,100,100,100,100,100,100,100,100,100,100,4
1,100,100,100,100,100,100,100,100,100,100,100,100,100,1,1
1,100,100,100,100,100,100,100,1,100,1,100,100,100,100,1
1,100,100,100,100,100,1,100,100,100,1,100,100,100,100,1
1,100,100,100,100,100,100,100,100,100,100,100,100,100,100,1
1,1,1,1,1,1,1,1,1,1,1,1,1,1,0,48