 0 ,0,0 ,0 ,0 ,0 ,0 ,0 ,0 ,0 ,0 ,0 ,0 ,0 ,0 ,0 ,0 ,0 ,0 ,0 ,0
 0 ,0,0 ,0 ,0 ,0 ,0 ,0 ,0 ,0 ,0 ,0 ,0 ,0 ,0 ,0 ,0 ,0 ,0 ,0 ,0
 0 ,0,0 ,0 ,0 ,0 ,1 ,1 ,1 ,1 ,1 ,1 ,1 ,1 ,1 ,0 ,0 ,0 ,0 ,0 ,0
 0 ,0,0 ,0 ,0 ,0 ,1 ,4 ,1 ,0 ,0 ,3 ,2 ,0 ,1 ,0 ,0 ,0 ,0 ,0 ,0
 0 ,0,0 ,0 ,0 ,0 ,1 ,0 ,1 ,0 ,0 ,4 ,1 ,0 ,1 ,0 ,0 ,0 ,0 ,0 ,0
 0 ,0,0 ,0 ,0 ,0 ,1 ,48 ,0 ,2 ,1 ,1 ,0 ,0 ,1 ,0 ,0 ,0 ,0 ,0 ,0
 0 ,0,0 ,0 ,0 ,0 ,1 ,0 ,1 ,3 ,0 ,3 ,2 ,0 ,1 ,0 ,0 ,0 ,0 ,0 ,0
 0 ,0,0 ,0 ,0 ,0 ,1 ,0 ,0 ,0 ,1 ,4 ,1 ,0 ,1 ,0 ,0 ,0 ,0 ,0 ,0
 0 ,0,0 ,0 ,0 ,0 ,1 ,1 ,1 ,0 ,0 ,1 ,0 ,0 ,1 ,0 ,0 ,0 ,0 ,0 ,0
 0 ,0,0 ,0 ,0 ,0 ,1 ,4 ,0 ,0 ,0 ,0 ,0 ,0 ,1 ,0 ,0 ,0 ,0 ,0 ,0
 0 ,0,0 ,0 ,0 ,0 ,1 ,1 ,1 ,1 ,1 ,1 ,1 ,1 ,1 ,0 ,0 ,0 ,0 ,0 ,0
 0 ,0,0 ,0 ,0 ,0 ,0 ,0 ,0 ,0 ,0 ,0 ,0 ,0 ,0 ,0 ,0 ,0 ,0 ,0 ,0
0 ,0,0 ,0 ,0 ,0 ,0 ,0 ,0 ,0 ,0 ,0 ,0 ,0 ,0 ,0 ,0 ,0 ,0 ,0 ,0