0 , 0 , 0 , 0 , 0 , 0 , 0 , 0 , 0 , 0 , 0 , 0  , 0 , 0 , 0 , 0 , 0 , 0 , 0 , 0 , 0
0 , 0 , 0 , 0 , 0 , 0 , 0 , 0 , 0 , 1 , 1 , 1  , 1 , 1 , 1 , 1 , 1 , 1 , 0 , 0 , 0
0 , 0 , 0 , 0 , 0 , 0 , 0 , 0 , 0 , 1 , 0 , 0  , 0 , 3 , 2 , 0 , 0 , 1 , 0 , 0 , 0
0 , 0 , 0 , 0 , 0 , 0 , 0 , 0 , 0 , 1 , 0 , 2  , 0 , 4 , 1 , 0 , 3 , 1 , 0 , 0 , 0
0 , 0 , 0 , 0 , 0 , 0 , 0 , 0 , 0 , 1 , 4 , 3  , 1 , 1 , 1 , 3 , 0 , 1 , 0 , 0 , 0
0 , 0 , 0 , 0 , 0 , 0 , 0 , 0 , 0 , 1 , 3 , 0  , 0 , 3 , 2 , 0 , 0 , 1 , 0 , 0 , 0
0 , 0 , 0 , 0 , 0 , 0 , 0 , 0 , 0 , 1 , 0 , 0  , 1 , 4 , 1 , 0 , 0 , 1 , 0 , 0 , 0
0 , 0 , 0 , 0 , 0 , 0 , 0 , 0 , 0 , 1 , 0 , 48 , 1 , 1 , 1 , 0 , 4 , 1 , 0 , 0 , 0
0 , 0 , 0 , 0 , 0 , 0 , 0 , 0 , 0 , 1 , 3 , 0  , 3 , 2 , 2 , 2 , 0 , 1 , 0 , 0 , 0
0 , 0 , 0 , 0 , 0 , 0 , 0 , 0 , 0 , 1 , 0 , 3  , 1 , 4 , 1 , 0 , 3 , 1 , 1 , 0 , 0
0 , 0 , 0 , 0 , 0 , 0 , 0 , 0 , 0 , 1 , 1 , 0  , 1 , 1 , 1 , 3 , 0 , 0 , 1 , 0 , 0
0 , 0 , 0 , 0 , 0 , 0 , 0 , 0 , 0 , 0 , 1 , 0  , 0 , 2 , 0 , 0 , 0 , 0 , 1 , 0 , 0
0 , 0 , 0 , 0 , 0 , 0 , 0 , 0 , 0 , 0 , 1 , 0  , 2 , 0 , 2 , 4 , 0 , 1 , 1 , 0 , 0
0 , 0 , 0 , 0 , 0 , 0 , 0 , 0 , 0 , 0 , 1 , 1  , 1 , 1 , 1 , 1 , 1 , 1 , 0 , 0 , 0