0,0,0,0,0,0,0,0,0,0,0,0,0,0,0,0,0,0,0,0
0,1,1,1,0,2,0,2,0,3,0,0,0,3,0,0,0,0,0,0
0,0,1,0,0,2,0,2,0,0,3,0,3,0,0,0,0,0,0,0
0,0,1,0,0,2,0,2,0,0,0,3,0,0,0,0,0,0,0,0
0,0,1,0,0,2,0,2,0,0,3,0,3,0,0,0,0,0,0,0
0,0,1,0,0,2,2,2,0,3,0,0,0,3,0,0,0,0,0,0
0,0,0,0,0,0,0,0,0,0,0,0,0,0,0,0,0,0,0,0
0,0,114,114,114,  0,110,0,0,48,30,0,0,0,0,0,0,0,0,0
0,0,114,0,  114,  0,110,0,0,81,44,92,0,0,0,0,0,0,0,0
0,0,114,0,  114,  0,110,0,0,51,0,93,0,0,0,0,0,0,0,0
0,0,114,0,  114,  0,110,0,0,61,0,100,0,0,0,0,0,0,0,0
0,0,114,0,  114,  0,110,0,0,20,0,56,0,0,0,0,0,0,0,0
0,0,114,114,114,  0,110,0,0,21,55,0,0,0,0,0,0,0,0,0
0,0,0,0,0,0,0,0,0,0,0,0,0,0,0,0,0,0,0,0