					 0, 0, 0, 0, 0, 0, 0, 0, 0, 0, 0, 0, 0, 0, 0, 0, 0, 0, 0 
					 0, 0, 0, 0, 0, 1, 1, 1, 1, 51, 1, 1, 1, 1, 0, 0, 0, 0, 0 
					 0, 0, 0, 0, 0, 1, 0, 1, 0, 0, 0, 1, 1, 1, 0, 0, 0, 0, 0 
					 0, 0, 0, 0, 0, 1, 0, 2, 2, 2, 2, 2, 48, 1, 0, 0, 0, 0, 0 
					 0, 0, 0, 0, 0, 1, 0, 2, 2, 2, 2, 2, 0, 1, 0, 0, 0, 0, 0 
					 0, 0, 0, 0, 0, 1, 0, 2, 2, 3, 2, 2, 0, 1, 0, 0, 0, 0, 0 
					 0, 0, 4, 0, 0, 1, 0, 2, 3, 61, 3, 2, 0, 1, 0, 0, 0, 0, 0 
					 0, 0, 0, 0, 0, 1, 0, 3, 2, 2, 2, 3, 0, 1, 0, 0, 0, 0, 0 
					 0, 0, 0, 0, 0, 1, 0, 2, 2, 2, 2, 2, 0, 1, 0, 0, 0, 0, 0 
					 0, 0, 0, 0, 0, 1, 0, 0, 0, 0, 0, 0, 0, 1, 0, 0, 0, 0, 0 
					 0, 0, 0, 0, 0, 1, 1, 1, 1, 1, 1, 1, 1, 1, 0, 0, 0, 0, 0 
					 0, 0, 0, 0, 0, 0, 0, 0, 0, 0, 0, 0, 0, 0, 0, 0, 0, 0, 0 
					 0, 0, 0, 0, 0, 0, 0, 0, 0, 0, 0, 0, 0, 0, 0, 0, 0, 0, 0 