1 , 1  , 1 , 1  , 1  , 1  , 1  , 1  , 1  , 1  , 1  , 1 , 1  , 1  , 1  , 1 , 1 , 1
1 , 0  , 4 , 4  , 0  , 0  , 0  , 0  , 1  , 0  , 0  , 0 , 48 , 0  , 0  , 0 , 0 , 1
1 , 0  , 0 , 0  , 0  , 0  , 0  , 0  , 1  , 0  , 0  , 0 , 3  , 0  , 70 , 0 , 0 , 1
1 , 0  , 0 , 0  , 0  , 0  , 0  , 0  , 1  , 0  , 0  , 3 , 20 , 0  , 0  , 0 , 0 , 1
1 , 1  , 1 , 1  , 92 , 1  , 1  , 1  , 1  , 0  , 0  , 0 , 0  , 0  , 0  , 0 , 0 , 1
1 , 0  , 0 , 0  , 0  , 0  , 0  , 0  , 1  , 0  , 0  , 0 , 0  , 0  , 0  , 0 , 0 , 1
1 , 0  , 0 , 0  , 0  , 0  , 0  , 0  , 1  , 0  , 0  , 0 , 0  , 0  , 0  , 0 , 0 , 1
1 , 0  , 0 , 0  , 0  , 0  , 0  , 0  , 1  , 0  , 0  , 0 , 0  , 0  , 0  , 0 , 0 , 1
1 , 0  , 0 , 0  , 0  , 0  , 0  , 0  , 1  , 0  , 0  , 0 , 0  , 0  , 0  , 0 , 0 , 1
1 , 0  , 0 , 0  , 0  , 0  , 0  , 0  , 1  , 0  , 0  , 0 , 0  , 0  , 0  , 0 , 0 , 1
1 , 0  , 0 , 0  , 0  , 0  , 0  , 0  , 1  , 0  , 0  , 0 , 0  , 0  , 0  , 0 , 0 , 91
1 , 0  , 0 , 0  , 0  , 0  , 0  , 0  , 1  , 0  , 0  , 0 , 0  , 0  , 0  , 0 , 0 , 1
1 , 70 , 0 , 0  , 0  , 0  , 0  , 0  , 1  , 0  , 0  , 0 , 0  , 0  , 0  , 0 , 0 , 1
1 , 1  , 1 , 1  , 1  , 1  , 1  , 1  , 1  , 1  , 1  , 1 , 1  , 1  , 1  , 1 , 1 , 1

1 , 1  , 1 , 1  , 1  , 1  , 1  , 1  , 1  , 1  , 1  , 1 , 1  , 1  , 1  , 1 , 1 , 1
1 , 0  , 0 , 0  , 1  , 0  , 0  , 0  , 0  , 0  , 0  , 0 , 0  , 0  , 0  , 0 , 0 , 1
1 , 0  , 0 , 0  , 1  , 0  , 0  , 0  , 0  , 0  , 0  , 0 , 0  , 0  , 71 , 0 , 0 , 1
1 , 0  , 0 , 55 , 1  , 0  , 0  , 0  , 0  , 0  , 0  , 0 , 0  , 0  , 0  , 0 , 0 , 1
1 , 0  , 0 , 0  , 1  , 0  , 0  , 0  , 0  , 0  , 0  , 0 , 21 , 40 , 0  , 0 , 0 , 1
1 , 0  , 0 , 0  , 1  , 0  , 0  , 0  , 0  , 0  , 0  , 0 , 0  , 0  , 0  , 0 , 0 , 1
1 , 0  , 0 , 0  , 0  , 0  , 0  , 0  , 0  , 0  , 0  , 0 , 0  , 0  , 0  , 0 , 0 , 1
1 , 0  , 0 , 0  , 1  , 0  , 0  , 0  , 0  , 0  , 0  , 0 , 0  , 0  , 0  , 0 , 0 , 1
1 , 0  , 0 , 0  , 1  , 0  , 0  , 0  , 0  , 0  , 0  , 0 , 0  , 0  , 0  , 0 , 0 , 1
1 , 0  , 0 , 0  , 1  , 0  , 0  , 0  , 0  , 0  , 0  , 0 , 0  , 0  , 0  , 0 , 0 , 1
1 , 1  , 1 , 34 , 35 , 35 , 35 , 35 , 35 , 35 , 0  , 1 , 1  , 1  , 1  , 1 , 1 , 1
1 , 0  , 0 , 0  , 0  , 0  , 0  , 0  , 0  , 0  , 55 , 0 , 0  , 0  , 0  , 0 , 0 , 1
1 , 71 , 0 , 0  , 0  , 0  , 0  , 0  , 0  , 0  , 0  , 0 , 0  , 0  , 0  , 0 , 0 , 1
1 , 1  , 1 , 1  , 1  , 1  , 1  , 1  , 1  , 1  , 1  , 1 , 1  , 1  , 1  , 1 , 1 , 1